11111111111111111111111
10000000000000000000001
10111111101111111111111
10100000000000000011101
10111000011111111110001
10001011110000011010111
10101000000000011000001
10001111100000011110011
10001110000000000C0C001
10100001111C10001111111
101111111001C0111000001
10111111E10000000011101
100000010000C00111111P1
11111111111111111111111