11111111111111111111111
10000000000000000000001
10111111101111100000001
10100000000000000000001
10100000011111111011111
10001111110000010000001
10100000000000011111001
10000011100000011110011
10001000000000000000001
10001111111000001111111
1000000000000000100C001
1000000E000P00001000001
10000000000000001000001
11111111111111111111111