11111111111111111111111
10P00000000000000000001
10111111111111100000E01
10100000000000000000001
10100000011111111111111
10001111110000000000001
10100000000000011111001
10000011100000011111001
10001000000000000000001
10C01111111000001111111
10000000000000000000001
11111111111111111111111