11111111111111111111111
10000E0C0C0000000000001
10111111111111100000001
10100000000000000000001
101000E0011111111111111
100011111100000E0000001
10100000000000011111001
10000011100000011110011
10001000000000000000001
10001111111000001011111
10000000000000000000001
100P0000000000000000001
10000000000000000000001
11111111111111111111111