11111A11111111111111111
10000000000000000000001
1111111111111110000E001
10100000000000000000001
10100000011111111111111
10001111110000000000001
10100000000000011111001
100000111000P0011111001
10C01000000000000000001
10001111111000001111111
10000000000000000000001
11111111111111111111111
11111111111111111111111
11111111111111111111111
11111111111111111111111
11111111111111111111111
ABCD1111111111111111111
11111111111111111111111
11111111111111111111111
11111111111111111111111
11111111111111111111111
11111111111111111111111
11111111111XXXXXXXXXXXX
