11111111111111111111111
10000000000000000000001
1011111110111110000C001
10100000000000000000001
10100000011111111011111
10001111110000010000001
10100000000P00011111001
10000011100000011110011
10001000000000000C0C001
10001111111000001111111
10000000000000001000001
10000000E0000000000C001
10000000000000001000C01
11111111111111111111111